###########
#K#..E..#$#
#~#..M..#.#
#M##$####~#
#.#.....#.#
#$####$##.#
#.........#
#@........#
###########