####################
#............$$#...#
#~##$##$##$##$##.#.#
#M#......@.......#.#
#.################.#
#...~.E.K.M.M......#
####################