###########
#$#..E..#$#
#.#.....#.#
#$##$####.#
#.#.....#.#
#$####$##.#
#.........#
#@........#
###########