##########
#.......E#
#.######.#
#......#.#
#......#.#
#......#.#
#......#.#
#@.......#
##########